Name: keyring
Version: 23.13.1
Summary: Store and access your passwords safely.
Home-page: https://github.com/jaraco/keyring
Author: Kang Zhang
Author-email: jobo.zh@gmail.com
License: 
Location: /home/mic/.local/lib/python3.10/site-packages
Requires: importlib-metadata, jaraco.classes, jeepney, SecretStorage
Required-by: jrnl, twine
Metadata-Version: 2.1
Installer: pip
Classifiers:
  Development Status :: 5 - Production/Stable
  Intended Audience :: Developers
  License :: OSI Approved :: MIT License
  Programming Language :: Python :: 3
  Programming Language :: Python :: 3 :: Only
Entry-points:
  [console_scripts]
  keyring = keyring.cli:main
  
  [devpi_client]
  keyring = keyring.devpi_client
  
  [keyring.backends]
  KWallet = keyring.backends.kwallet
  SecretService = keyring.backends.SecretService
  Windows = keyring.backends.Windows
  chainer = keyring.backends.chainer
  libsecret = keyring.backends.libsecret
  macOS = keyring.backends.macOS
Project-URLs:
